00000000000000000000
00002220000000000000
00000000000000222000
00000000000000000000
00000000000000000000
00000000000000000000
00000000000000000000
00000000000000222000
00000000000000000000
00000000000000000000
00000000000000000000
00000000000000000000
00000000000000000000
00000000000000000000
11111111111111111111